13*13*
#############
#    ### ## #
#### #      #
#### # #### #
##   # #    #
## #   # # ##
#  ### #   ##
#   ## # #  #
### ##   ## #
#   ####### #
# ####      #
#      ###  #
#############