10*20*
####################
#..................#
#....####..........#
#.#..#..#..........#
#.##.#....#######..#
#.#.....#....#.....#
#.#...#.#....#.....#
#.#.#.##.....#.....#
#......#...........#
####################