15*30* 
##############################
# ############################
#             ##             #
#                            #
#     #                #     #
#             ##             #
#             ##             #
### ## ## ## #### ## ## ## ###
#             ##             #
#             ##             #
#     #                #     #
#                            #
#             ##             #
############################ #
##############################